Abhi2011 = Abhijit Nandy <abhijit.nandy@gmail.com>
abhi2011 = Abhijit Nandy <abhijit.nandy@gmail.com>
adam = Adam Ross <aross@ara.com>
agkphysics = Aaron Keesing <agkphysics@gmail.com>
andrecastelo = Andr√© Castelo <andrecastelo@gmail.com>
anrgmrty = Anurag Murty <anuragmurty@gmail.com>
bharder = Brad Harder <brad.harder@gmail.com>
bhinesley = Brandon Hinesley <bhinesley@gmail.com>
bob1961 = Robert Parker <unacknowledged@users.noreply.github.com>
bparker = Robert Parker <unacknowledged@users.noreply.github.com>
brlcad = Christopher Sean Morrison <brlcad@gmail.com>
butler = Lee Butler <iraytrace@users.noreply.github.com>
caen23 = Cezar El-Nazli <cezar.elnazli2@gmail.com>
carlmoore = Carl Moore <carlm0404@gmail.com>
cjohnson = Christopher Johnson <cjohnson@brlcad.org>
cnuzman = Carl Nuzman <carl.nuzman@nokia-bell-labs.com>
cprecup = Cristina Precup <cprecup@cisco.com>
crdueck = Chris Dueck <cdueck93@gmail.com>
d_rossberg = Daniel Rossberg <drossberg@users.noreply.github.com>
davidloman = David Loman <dloman77@gmail.com>
ddreeves70 = David Reeves <ddreeves70@brlcad.org>
dgodbey = David Godbey <dgodbey@yahoo.com>
dhoward = Doug Howard <doug@survice.com>
dpk = Douglas Kingston <dpk@randomnotes.org>
dtremenak = Daniel Remenak <dtremenak@gmail.com>
ebautu = Elena Bautu <ebautu@gmail.com>
ejno = Jonathan Engbert <5529404+ejno@users.noreply.github.com>
erikg = Erik Greenwald <erik@brlcad.org>
erikgreenwald = Erik Greenwald <erik@brlcad.org>
g2asc = Charles Kennedy <kermit@brlcad.org>
gabbar1947 = Shubham Rathore <shubhamrathore1947@gmail.com>
gdurf = Glenn Durfee <gdurfee@gmail.com>
gwyn = Douglas Gwyn <dagwyn@aol.com>
hartley = Robert Hartley <hartley@brlcad.org>
homovulgaris = Dawn Thomas <thedawnthomas@gmail.com>
iiizzzaaakkk = Isacc Kamga <u2isaac@gmail.com>
indianlarry = Keith Boman <indianlarry@verizon.net>
irpguardian = Stephen Kennedy <59673185+irpguardian@users.noreply.github.com>
j-schulte = Johannes Schulte <28735406+johannesschulte@users.noreply.github.com>
jdoliner = Joe Doliner <jdoliner@gmail.com>
jebbly = Jeffrey Liu <38666957+Jebbly@users.noreply.github.com>
jehunt = Jim Hunt  <34352066+jhuntara@users.noreply.github.com>
jgrosh = John Grosh <jgrosh@brlcad.org>
jimhunt = Jim Hunt  <34352066+jhuntara@users.noreply.github.com>
jlowens = Jason Owens <jlowenz@brlcad.org>
jlowenz = Jason Owens <jlowenz@brlcad.org>
joevalleyfield = Timothy Myers <tim@jvsw.com>
johnranderson = John Anderson <daytonajra@gmail.com>
jordisayol = Jordi Sayol <g.sayol@gmail.com>
jra = John Anderson <daytonajra@gmail.com>
justin = Justin Shumaker <twingy@brlcad.org>
kermit = Charles Kennedy <kermit@brlcad.org>
kunigami = Guilherme Kunigami <kunigami@gmail.com>
lbutler = Lee Butler <iraytrace@users.noreply.github.com>
louipc = Loui Chang <louipc@gmx.com>
mafm = Manuel Montecelo <manuel.montezelo@gmail.com>
maths22 = Jacob Burroughs <maths22@gmail.com>
mccarty = Cormac McCarty <mccarty@brlcad.org>
mdtwenty = Marco da Silva Domingues <marcodomingues20@gmail.com>
mendesr = Roger Mendes <mendesr@brlcad.org>
merritt = Don Merritt <merritt@brlcad.org>
mgillich = Michael Gillich <michael.j.gillich@gmail.com>
mike = Michael John Muuss <mike@brlcad.org>
mjgillich = Michael Gillich <michael.j.gillich@gmail.com>
mm = Michael Markowski <mmark@brlcad.org>
mmark = Michael Markowski <mmark@brlcad.org>
mohitdaga = Mohit Daga <mohitdaga.lnmiit@gmail.com>
morrison = Christopher Sean Morrison <brlcad@gmail.com>
moss = Gary Moss <garysmoss@gmail.com>
n_reed = Nicholas Reed <nreed1@umbc.edu>
pacman87 = Timothy Van Ruitenbeek <pacman87@brlcad.org>
peter-sa = Peter Amidon <peter@brlcad.org>
phil = Phillip Dykstra <phil@brlcad.org>
phoenixyjll = Wu Jianbang <phoenixyjll@gmail.com>
pjt = Paul Tanenbaum <pjt@brlcad.org>
poolio = Ben Poole <bpoolio@gmail.com>
popescuandrei = Andrei-Constantin Popescu <popescu.andrei1991@gmail.com>
prasad_silva = Prasad Prometheus Silva <prasad.silva@gmail.com>
r_weiss = Richard Weiss <r_weiss@brlcad.org>
ralith = Benjamin Saunders <ben.e.saunders@gmail.com>
rbowers = Ronald Bowers <rbowers@brlcad.org>
reschly = Robert Reschly <robert.reschly@gmail.com>
ronaldbowers = Ronald Bowers <rbowers@brlcad.org>
root = root <mike@brlcad.org>
sammy = Samuel Hocevar <sam@hocevar.net>
scoates = Susan Coates <scoates@brlcad.org>
sharannyn = Saran Narayan <sharan.nyn@gmail.com>
starseeker = Clifford Yapp <238416+starseeker@users.noreply.github.com>
stay = Paul Stay <stay@brlcad.org>
stebich = Armin Stebich <lordofbikes@brlcad.org>
stefanmirea = Stefan Mirea <mireastefangabriel@gmail.com>
steveb = Stephen Buckley <steveb@brlcad.org>
sue = Susanne Muuss <sue@brlcad.org>
tbrowder2 = Thomas Browder <tom.browder@gmail.com>
tcs = Terry Slattery <tcs@brlcad.org>
tossup = tossup <tossup@brlcad.org>
tranese = TraNese Christy <skeeter@brlcad.org>
twingy = Justin Shumaker <twingy@brlcad.org>
vasco_costa = Vasco Alexandre da Silva Costa <1638760+vcosta@users.noreply.github.com>
vladbogo = Vlad Bogolin <vladbogolin@gmail.com>
wm = William Mermagen <bilmer1@comcast.net>
zhaoanqing = Zhao Anqing <zaqcloud@hotmail.com>
